0000000010000000000000000000000000000000000000000000000000000000000000000000000000000000000000000000000000000000000000000000000000000000000000001000000000000000000000001111011110110110101001011110100000000000000000000000000000000000000000000000000000
0000000010000000000000000000000000000000000000000000000000000000000000000000000000000000000000000000000000000000000000000000000000000000000000001000000000000000000000001000010010101010101101010000100000110000110011000000000000000000000000000000000000
0000000010000000000000000000000000000000000000000000000000000111111111111111111111111111111100000000000000000000000000000000000000000000000000001000000000000000000000001000010010100010101011010110100000110000110011000000000000000000000000000000000000
0000000010000000000000000000000000000000000000011111111111110000000000000000000000000000000001111111111111000000000000000000000000000000000000001000000000000000000000001000010010100010101001010010100000110000110011000000000000000000000000000000000000
0000000010000000000000000000000011111111111111000000000000000000000000000000000000000000000000000000000000011111111111111000000000000000000000001000000000000000000000001111011110100010101001011110100000110000110011000000000000000000000000000000000000
0000000010000000000000000000000000000000000000000000000000000000000000000000000000000000000000000000000000000000000000000000000000000000000000001000000000000000000000000000000000000000000000000000100000110000110011000000000000000000000000000000000000
0000000010000000000000000000000000000000000000000000000000000000000000000000000000000000000000000000000000000000000000000000000000000000000000001000000000000000000000000000000000000000000000000000100000111111110011000000000000000000000000000000000000
0000000011111111111000011111111111111111111111111111111111111111111111111111111111111111111111111111111111111111111111111111111111000011111111111000000000000000000000000000111101111011110100101010100000111111110011000000000000000000000000000000000000
0000000010000000000000000000000000000000000000000000000000000000000000000000000000000000000000000000000000000000000000000000000000000000000000001000000000000000000000000000100001001010010110101010100000110000110011000000000000000000000000000000000000
0000000010000000000000000000000000000000000000000000000000000000000000000000000000000000000000000000000000000000000000000000000000000000000000001000000000000000000000000000111101001010010101101010100000110000110011000000000000000000000000000000000000
0000000011111100001111111111111111111110000000000000000000000000000000000000000000000000000000000000000000000000001111111111111111111110000111111000000000000000000000000000000101001010010100100000100000110000110011000000000000000000000000000000000000
0000000010000000000000000000000000000000000111111111111111111111111111111111111111111111111111111111111111111100000000000000000000000000000000000000000000000000000000000000111101111011110100101010100000110000110011000000000000000000000000000000000000
0000000010000000000000000000000000000000000100000000000000000000000000000000000000000000000000000000000000000100000000000000000000000000000000000000000000000000000000000000000000000000000000000000100000110000110011000000000000000000000000000000000000
0000000010000000000000000000000000000000000100000000000000000000000000000000000000000000000000000000000000000100000000000000000000000000000000000000000000000000000000000000000000000000000000000000100000000000000000000000000000000000000000000000000000
GGGGGGGG1GGGGGGGGGGGGGGGGGGGGGGGGGGGGGGGGGG1GGG0000000000000000000000000000000000000000000000000000000000GGGG1GGGGGGGGGGGGGGGGGGGGGGGGGGGGGGGGGGGGGGGGGGGGGGGGGGGGGGGGGGGGGGGGGGGGGGGGGGGGGGGGGGGGGG1GGGGGGGGGGGGGG000000000000000000000000000000000000000
