000000001000000000000000000000000000000000000000000000000000000000000000000000000000000000000000000000000000000000000000000000000000000000000000100000000000000000000000111101111011011010100101111001
000000001000000000000000000000000000000000000000000000000000000000000000000000000000000000000000000000000000000000000000000000000000000000000000100000000000000000000000100001001010101010110101000001
000000001000000000000000000000000000000000000000000000000000011111111111111111111111111111110000000000000000000000000000000000000000000000000000100000000000000000000000100001001010001010101101011001
000000001000000000000000000000000000000000000001111111111111000000000000000000000000000000000111111111111100000000000000000000000000000000000000100000000000000000000000100001001010001010100101001001
000000001000000000000000000000001111111111111100000000000000000000000000000000000000000000000000000000000001111111111111100000000000000000000000100000000000000000000000111101111010001010100101111001
000000001000000000000000000000000000000000000000000000000000000000000000000000000000000000000000000000000000000000000000000000000000000000000000100000000000000000000000000000000000000000000000000001
000000001000000000000000000000000000000000000000000000000000000000000000000000000000000000000000000000000000000000000000000000000000000000000000100000000000000000000000000000000000000000000000000001
000000001111111111100001111111111111111111111111111111111111111111111111111111111111111111111111111111111111111111111111111111111100001111111111100000000000000000000000000011110111101111010010000001
000000001000000000000000000000000000000000000000000000000000000000000000000000000000000000000000000000000000000000000000000000000000000000000000100000000000000000000000000010000100101001011010000001
000000001000000000000000000000000000000000000000000000000000000000000000000000000000000000000000000000000000000000000000000000000000000000000000100000000000000000000000000011110100101001010110000001
000000001111110000111111111111111111111000000000000000000000000000000000000000000000000000000000000000000000000000111111111111111111111000011111100000000000000000000000000000010100101001010010000001
000000001000000000000000000000000000000000011111111111111111111111111111111111111111111111111111111111111111110000000000000000000000000000000000100000000000000000000000000011110111101111010010000001                                           
000000001000000000000000000000000000000000010000000000000000000000000000000000000000000000000000000000000000010000000000000000000000000000000000100000000000000000000000000000000000000000000000000001
000000001000000000000000000000000000000000010000000000000000000000000000000000000000000000000000000000000000010000000000000000000000000000000000100000000000000000000000000000000000000000000000000001
GGGGGGGGGGGGGGGGGGGGGGGGGGGGGGGGGGGGGGGGGGGGGGG0000000000000000000000000000000000000000000000000000000000GGGGGGGGGGGGGGGGGGGGGGGGGGGGGGGGGGGGGGGGGGGGGGGGGGGGGGGGGGGGGGGGGGGGGGGGGGGGGGGGGGGGGGGGGGGGGGGGGGGGGGGGGG







